,Id,Country,Country_Code,Gold_Medals,Silver_Medals,Bronze_Medals,Total
0,AFG_2008,Afghanistan,AFG,0,0,1,1
1,AHO_1988,Netherland Antilles,AHO,0,1,0,1
2,ALG_1984,Algeria,ALG,0,0,2,2
3,ALG_1992,Algeria,ALG,1,0,1,2
4,ALG_1996,Algeria,ALG,2,0,1,3
5,ALG_2000,Algeria,ALG,1,1,3,5
6,ALG_2008,Algeria,ALG,0,1,1,2
7,ANZ_1908,Australasia (until 1920),ANZ,1,2,2,5
8,ANZ_1912,Australasia (until 1920),ANZ,2,2,3,7
9,ARG_1924,Argentina,ARG,1,3,2,6
10,ARG_1928,Argentina,ARG,3,3,1,7
11,ARG_1932,Argentina,ARG,3,1,0,4
12,ARG_1936,Argentina,ARG,2,2,3,7
13,ARG_1948,Argentina,ARG,3,3,1,7
14,ARG_1952,Argentina,ARG,1,2,2,5
15,ARG_1956,Argentina,ARG,0,1,1,2
16,ARG_1960,Argentina,ARG,0,1,1,2
17,ARG_1964,Argentina,ARG,0,1,0,1
18,ARG_1968,Argentina,ARG,0,0,2,2
19,ARG_1972,Argentina,ARG,0,1,0,1
20,ARG_1988,Argentina,ARG,0,1,1,2
21,ARG_1992,Argentina,ARG,0,0,1,1
22,ARG_1996,Argentina,ARG,0,2,1,3
23,ARG_2000,Argentina,ARG,0,2,2,4
24,ARG_2004,Argentina,ARG,2,0,4,6
25,ARG_2008,Argentina,ARG,2,0,4,6
26,ARM_1996,Armenia,ARM,1,1,0,2
27,ARM_2000,Armenia,ARM,0,0,2,2
28,ARM_2008,Armenia,ARM,0,0,6,6
29,AUS_1896,Australia,AUS,2,0,0,2
30,AUS_1900,Australia,AUS,2,0,3,5
31,AUS_1906,Australia,AUS,0,0,3,3
32,AUS_1920,Australia,AUS,0,2,1,3
33,AUS_1924,Australia,AUS,3,1,2,6
34,AUS_1928,Australia,AUS,1,2,1,4
35,AUS_1932,Australia,AUS,3,1,1,5
36,AUS_1936,Australia,AUS,0,0,1,1
37,AUS_1948,Australia,AUS,2,6,5,13
38,AUS_1952,Australia,AUS,6,2,3,11
39,AUS_1956,Australia,AUS,13,8,14,35
40,AUS_1960,Australia,AUS,8,8,6,22
41,AUS_1964,Australia,AUS,6,2,10,18
42,AUS_1968,Australia,AUS,5,7,5,17
43,AUS_1972,Australia,AUS,8,7,2,17
44,AUS_1976,Australia,AUS,0,1,4,5
45,AUS_1980,Australia,AUS,2,2,5,9
46,AUS_1984,Australia,AUS,4,8,12,24
47,AUS_1988,Australia,AUS,3,6,5,14
48,AUS_1992,Australia,AUS,7,9,11,27
49,AUS_1996,Australia,AUS,9,9,23,41
50,AUS_2000,Australia,AUS,16,25,17,58
51,AUS_2004,Australia,AUS,17,16,16,49
52,AUS_2008,Australia,AUS,14,15,17,46
53,AUT_1896,Austria,AUT,2,1,2,5
54,AUT_1900,Austria,AUT,0,3,3,6
55,AUT_1904,Austria,AUT,0,0,1,1
56,AUT_1906,Austria,AUT,3,3,3,9
57,AUT_1908,Austria,AUT,0,0,1,1
58,AUT_1912,Austria,AUT,0,2,2,4
59,AUT_1924,Austria,AUT,0,3,1,4
60,AUT_1928,Austria,AUT,3,0,1,4
61,AUT_1932,Austria,AUT,1,1,3,5
62,AUT_1936,Austria,AUT,5,7,5,17
63,AUT_1948,Austria,AUT,2,2,4,8
64,AUT_1952,Austria,AUT,0,1,1,2
65,AUT_1956,Austria,AUT,0,0,2,2
66,AUT_1960,Austria,AUT,1,1,0,2
67,AUT_1968,Austria,AUT,0,2,2,4
68,AUT_1972,Austria,AUT,0,1,2,3
69,AUT_1976,Austria,AUT,0,0,1,1
70,AUT_1980,Austria,AUT,1,2,1,4
71,AUT_1984,Austria,AUT,1,1,1,3
72,AUT_1988,Austria,AUT,1,0,0,1
73,AUT_1992,Austria,AUT,0,2,0,2
74,AUT_1996,Austria,AUT,0,1,2,3
75,AUT_2000,Austria,AUT,2,1,0,3
76,AUT_2004,Austria,AUT,2,4,1,7
77,AUT_2008,Austria,AUT,0,1,2,3
78,AZE_1996,Azerbaijan,AZE,0,1,0,1
79,AZE_2000,Azerbaijan,AZE,2,0,1,3
80,AZE_2004,Azerbaijan,AZE,1,0,4,5
81,AZE_2008,Azerbaijan,AZE,1,2,5,8
82,BAH_1956,Bahamas,BAH,0,0,1,1
83,BAH_1964,Bahamas,BAH,1,0,0,1
84,BAH_1992,Bahamas,BAH,0,0,1,1
85,BAH_1996,Bahamas,BAH,0,1,0,1
86,BAH_2000,Bahamas,BAH,2,0,0,2
87,BAH_2004,Bahamas,BAH,1,0,1,2
88,BAH_2008,Bahamas,BAH,0,1,1,2
89,BAR_2000,Barbados,BAR,0,0,1,1
90,BDI_1996,Burundi,BDI,1,0,0,1
91,BEL_1900,Belgium,BEL,6,5,5,16
92,BEL_1906,Belgium,BEL,2,1,3,6
93,BEL_1908,Belgium,BEL,1,5,2,8
94,BEL_1912,Belgium,BEL,2,1,3,6
95,BEL_1920,Belgium,BEL,16,12,14,42
96,BEL_1924,Belgium,BEL,3,7,3,13
97,BEL_1928,Belgium,BEL,0,1,2,3
98,BEL_1932,Belgium,BEL,0,0,1,1
99,BEL_1936,Belgium,BEL,0,0,3,3
100,BEL_1948,Belgium,BEL,2,2,3,7
101,BEL_1952,Belgium,BEL,2,2,0,4
102,BEL_1956,Belgium,BEL,0,2,0,2
103,BEL_1960,Belgium,BEL,0,2,2,4
104,BEL_1964,Belgium,BEL,2,0,1,3
105,BEL_1968,Belgium,BEL,0,1,1,2
106,BEL_1972,Belgium,BEL,0,2,0,2
107,BEL_1976,Belgium,BEL,0,3,3,6
108,BEL_1980,Belgium,BEL,1,0,0,1
109,BEL_1984,Belgium,BEL,1,1,2,4
110,BEL_1988,Belgium,BEL,0,0,2,2
111,BEL_1992,Belgium,BEL,0,1,2,3
112,BEL_1996,Belgium,BEL,2,2,2,6
113,BEL_2000,Belgium,BEL,0,2,3,5
114,BEL_2004,Belgium,BEL,1,0,2,3
115,BEL_2008,Belgium,BEL,1,1,0,2
116,BER_1976,Bermuda,BER,0,0,1,1
117,BIN_1900,British India,BIN,0,2,0,2
118,BIN_1928,British India,BIN,1,0,0,1
119,BIN_1932,British India,BIN,1,0,0,1
120,BIN_1936,British India,BIN,1,0,0,1
121,BLR_1996,Belarus,BLR,1,6,8,15
122,BLR_2000,Belarus,BLR,3,3,11,17
123,BLR_2004,Belarus,BLR,2,6,7,15
124,BLR_2008,Belarus,BLR,4,5,9,18
125,BOH_1900,Bohemia,BOH,0,1,1,2
126,BOH_1906,Bohemia,BOH,0,0,2,2
127,BOH_1908,Bohemia,BOH,0,0,2,2
128,BRA_1920,Brazil,BRA,1,1,1,3
129,BRA_1948,Brazil,BRA,0,0,1,1
130,BRA_1952,Brazil,BRA,1,0,2,3
131,BRA_1956,Brazil,BRA,1,0,0,1
132,BRA_1960,Brazil,BRA,0,0,2,2
133,BRA_1964,Brazil,BRA,0,0,1,1
134,BRA_1968,Brazil,BRA,0,1,2,3
135,BRA_1972,Brazil,BRA,0,0,2,2
136,BRA_1976,Brazil,BRA,0,0,2,2
137,BRA_1980,Brazil,BRA,2,0,2,4
138,BRA_1984,Brazil,BRA,1,5,2,8
139,BRA_1988,Brazil,BRA,1,2,3,6
140,BRA_1992,Brazil,BRA,2,1,0,3
141,BRA_1996,Brazil,BRA,3,3,9,15
142,BRA_2000,Brazil,BRA,0,6,6,12
143,BRA_2004,Brazil,BRA,5,2,3,10
144,BRA_2008,Brazil,BRA,3,4,7,14
145,BRN_2008,Bahrain,BRN,1,0,0,1
146,BUL_1952,Bulgaria,BUL,0,0,1,1
147,BUL_1956,Bulgaria,BUL,1,3,1,5
148,BUL_1960,Bulgaria,BUL,1,3,3,7
149,BUL_1964,Bulgaria,BUL,3,5,2,10
150,BUL_1968,Bulgaria,BUL,2,4,3,9
151,BUL_1972,Bulgaria,BUL,6,10,5,21
152,BUL_1976,Bulgaria,BUL,6,9,7,22
153,BUL_1980,Bulgaria,BUL,8,16,17,41
154,BUL_1988,Bulgaria,BUL,10,12,13,35
155,BUL_1992,Bulgaria,BUL,3,7,6,16
156,BUL_1996,Bulgaria,BUL,3,7,5,15
157,BUL_2000,Bulgaria,BUL,5,6,2,13
158,BUL_2004,Bulgaria,BUL,2,1,9,12
159,BUL_2008,Bulgaria,BUL,1,1,3,5
160,BUR_2008,Burkina Faso,BUR,0,0,1,1
161,BWI_1960,British West Indies,BWI,0,0,2,2
162,CAN_1900,Canada,CAN,1,0,1,2
163,CAN_1904,Canada,CAN,4,1,1,6
164,CAN_1906,Canada,CAN,1,1,0,2
165,CAN_1908,Canada,CAN,3,3,10,16
166,CAN_1912,Canada,CAN,3,2,3,8
167,CAN_1920,Canada,CAN,3,3,3,9
168,CAN_1924,Canada,CAN,0,3,1,4
169,CAN_1928,Canada,CAN,4,4,7,15
170,CAN_1932,Canada,CAN,2,5,9,16
171,CAN_1936,Canada,CAN,1,3,5,9
172,CAN_1948,Canada,CAN,0,2,2,4
173,CAN_1952,Canada,CAN,1,2,0,3
174,CAN_1956,Canada,CAN,2,1,3,6
175,CAN_1960,Canada,CAN,0,1,0,1
176,CAN_1964,Canada,CAN,1,2,1,4
177,CAN_1968,Canada,CAN,1,3,1,5
178,CAN_1972,Canada,CAN,0,2,3,5
179,CAN_1976,Canada,CAN,0,5,6,11
180,CAN_1984,Canada,CAN,10,18,16,44
181,CAN_1988,Canada,CAN,3,2,5,10
182,CAN_1992,Canada,CAN,7,4,7,18
183,CAN_1996,Canada,CAN,3,11,8,22
184,CAN_2000,Canada,CAN,3,3,8,14
185,CAN_2004,Canada,CAN,3,6,3,12
186,CAN_2008,Canada,CAN,3,9,6,18
187,CHI_1928,Chile,CHI,0,1,0,1
188,CHI_1952,Chile,CHI,0,2,0,2
189,CHI_1956,Chile,CHI,0,2,2,4
190,CHI_1988,Chile,CHI,0,1,0,1
191,CHI_2000,Chile,CHI,0,0,1,1
192,CHI_2004,Chile,CHI,2,0,1,3
193,CHI_2008,Chile,CHI,0,1,0,1
194,CHN_1984,China,CHN,15,8,9,32
195,CHN_1988,China,CHN,5,11,12,28
196,CHN_1992,China,CHN,16,22,16,54
197,CHN_1996,China,CHN,16,22,12,50
198,CHN_2000,China,CHN,28,16,15,59
199,CHN_2004,China,CHN,32,17,14,63
200,CHN_2008,China,CHN,51,21,28,100
201,CIV_1984,Ivory Coast,CIV,0,1,0,1
202,CMR_1968,Cameroon,CMR,0,1,0,1
203,CMR_1984,Cameroon,CMR,0,0,1,1
204,CMR_2000,Cameroon,CMR,1,0,0,1
205,CMR_2004,Cameroon,CMR,1,0,0,1
206,CMR_2008,Cameroon,CMR,1,0,0,1
207,COL_1972,Colombia,COL,0,1,2,3
208,COL_1984,Colombia,COL,0,1,0,1
209,COL_1988,Colombia,COL,0,0,1,1
210,COL_1992,Colombia,COL,0,0,1,1
211,COL_2000,Colombia,COL,1,0,0,1
212,COL_2004,Colombia,COL,0,0,1,1
213,COL_2008,Colombia,COL,0,1,1,2
214,CRC_1988,Costa Rica,CRC,0,1,0,1
215,CRC_1996,Costa Rica,CRC,1,0,0,1
216,CRC_2000,Costa Rica,CRC,0,0,2,2
217,CRO_1992,Croatia,CRO,0,1,2,3
218,CRO_1996,Croatia,CRO,1,1,0,2
219,CRO_2000,Croatia,CRO,1,0,1,2
220,CRO_2004,Croatia,CRO,1,2,2,5
221,CRO_2008,Croatia,CRO,0,2,3,5
222,CUB_1900,Cuba,CUB,1,1,0,2
223,CUB_1904,Cuba,CUB,4,2,3,9
224,CUB_1948,Cuba,CUB,0,1,0,1
225,CUB_1964,Cuba,CUB,0,1,0,1
226,CUB_1968,Cuba,CUB,0,4,0,4
227,CUB_1972,Cuba,CUB,3,1,4,8
228,CUB_1976,Cuba,CUB,6,4,3,13
229,CUB_1980,Cuba,CUB,8,7,5,20
230,CUB_1992,Cuba,CUB,14,6,11,31
231,CUB_1996,Cuba,CUB,9,8,8,25
232,CUB_2000,Cuba,CUB,11,11,7,29
233,CUB_2004,Cuba,CUB,9,7,11,27
234,CUB_2008,Cuba,CUB,2,11,12,25
235,CZE_1920,Czechoslovakia (until 1992),CZE,0,0,2,2
236,CZE_1924,Czechoslovakia (until 1992),CZE,1,4,5,10
237,CZE_1928,Czechoslovakia (until 1992),CZE,2,5,2,9
238,CZE_1932,Czechoslovakia (until 1992),CZE,1,3,2,6
239,CZE_1936,Czechoslovakia (until 1992),CZE,3,5,1,9
240,CZE_1948,Czechoslovakia (until 1992),CZE,6,2,3,11
241,CZE_1952,Czechoslovakia (until 1992),CZE,7,3,3,13
242,CZE_1956,Czechoslovakia (until 1992),CZE,1,4,1,6
243,CZE_1960,Czechoslovakia (until 1992),CZE,3,2,3,8
244,CZE_1964,Czechoslovakia (until 1992),CZE,5,6,3,14
245,CZE_1968,Czechoslovakia (until 1992),CZE,7,2,4,13
246,CZE_1972,Czechoslovakia (until 1992),CZE,2,4,2,8
247,CZE_1976,Czechoslovakia (until 1992),CZE,2,2,4,8
248,CZE_1980,Czechoslovakia (until 1992),CZE,2,3,9,14
249,CZE_1988,Czechoslovakia (until 1992),CZE,3,3,2,8
250,CZR_1992,Czech Rep.,CZR,4,2,1,7
251,CZR_1996,Czech Rep.,CZR,4,3,4,11
252,CZR_2000,Czech Rep.,CZR,2,3,3,8
253,CZR_2004,Czech Rep.,CZR,1,3,4,8
254,CZR_2008,Czech Rep.,CZR,3,3,0,6
255,DEN_1896,Denmark,DEN,1,2,3,6
256,DEN_1900,Denmark,DEN,1,3,2,6
257,DEN_1906,Denmark,DEN,3,2,1,6
258,DEN_1908,Denmark,DEN,0,2,3,5
259,DEN_1912,Denmark,DEN,1,6,5,12
260,DEN_1920,Denmark,DEN,3,9,1,13
261,DEN_1924,Denmark,DEN,2,6,3,11
262,DEN_1928,Denmark,DEN,3,2,4,9
263,DEN_1932,Denmark,DEN,0,5,3,8
264,DEN_1936,Denmark,DEN,0,2,3,5
265,DEN_1948,Denmark,DEN,5,8,9,22
266,DEN_1952,Denmark,DEN,2,1,3,6
267,DEN_1956,Denmark,DEN,1,2,1,4
268,DEN_1960,Denmark,DEN,2,3,1,6
269,DEN_1964,Denmark,DEN,2,1,3,6
270,DEN_1968,Denmark,DEN,1,4,3,8
271,DEN_1972,Denmark,DEN,1,0,0,1
272,DEN_1976,Denmark,DEN,1,0,2,3
273,DEN_1980,Denmark,DEN,2,1,2,5
274,DEN_1984,Denmark,DEN,0,3,3,6
275,DEN_1988,Denmark,DEN,2,1,1,4
276,DEN_1992,Denmark,DEN,1,1,4,6
277,DEN_1996,Denmark,DEN,4,1,1,6
278,DEN_2000,Denmark,DEN,2,3,1,6
279,DEN_2004,Denmark,DEN,2,0,6,8
280,DEN_2008,Denmark,DEN,2,2,3,7
281,DEU_1896,Germany (until 1912),DEU,6,5,2,13
282,DEU_1900,Germany (until 1912),DEU,4,2,2,8
283,DEU_1904,Germany (until 1912),DEU,4,4,5,13
284,DEU_1906,Germany (until 1912),DEU,4,6,5,15
285,DEU_1908,Germany (until 1912),DEU,3,5,6,14
286,DEU_1912,Germany (until 1912),DEU,5,13,7,25
287,DJI_1988,Djibouti,DJI,0,0,1,1
288,DOM_1984,Dominican Rep.,DOM,0,0,1,1
289,DOM_2004,Dominican Rep.,DOM,1,0,0,1
290,DOM_2008,Dominican Rep.,DOM,1,1,0,2
291,ECU_1996,Ecuador,ECU,1,0,0,1
292,ECU_2008,Ecuador,ECU,0,1,0,1
293,EGY_1928,Egypt,EGY,2,1,1,4
294,EGY_1936,Egypt,EGY,2,1,2,5
295,EGY_1948,Egypt,EGY,2,2,1,5
296,EGY_1952,Egypt,EGY,0,0,1,1
297,EGY_1960,Egypt,EGY,0,1,1,2
298,EGY_1984,Egypt,EGY,0,1,0,1
299,EGY_2004,Egypt,EGY,1,1,3,5
300,EGY_2008,Egypt,EGY,0,0,1,1
301,ERI_2004,Eritrea,ERI,0,0,1,1
302,ESP_1900,Spain,ESP,1,0,0,1
303,ESP_1920,Spain,ESP,0,2,0,2
304,ESP_1928,Spain,ESP,1,0,0,1
305,ESP_1932,Spain,ESP,0,0,1,1
306,ESP_1948,Spain,ESP,0,1,0,1
307,ESP_1952,Spain,ESP,0,1,0,1
308,ESP_1960,Spain,ESP,0,0,1,1
309,ESP_1972,Spain,ESP,0,0,1,1
310,ESP_1976,Spain,ESP,0,2,0,2
311,ESP_1980,Spain,ESP,1,3,2,6
312,ESP_1984,Spain,ESP,1,2,2,5
313,ESP_1988,Spain,ESP,1,1,2,4
314,ESP_1992,Spain,ESP,13,7,2,22
315,ESP_1996,Spain,ESP,5,6,6,17
316,ESP_2000,Spain,ESP,3,3,5,11
317,ESP_2004,Spain,ESP,3,11,5,19
318,ESP_2008,Spain,ESP,6,10,3,19
319,EST_1920,Estonia,EST,1,2,0,3
320,EST_1924,Estonia,EST,1,1,4,6
321,EST_1928,Estonia,EST,2,1,2,5
322,EST_1936,Estonia,EST,2,2,3,7
323,EST_1992,Estonia,EST,1,0,1,2
324,EST_2000,Estonia,EST,1,0,2,3
325,EST_2004,Estonia,EST,0,1,2,3
326,EST_2008,Estonia,EST,1,1,0,2
327,ETH_1960,Ethiopia,ETH,1,0,0,1
328,ETH_1964,Ethiopia,ETH,1,0,0,1
329,ETH_1968,Ethiopia,ETH,1,1,0,2
330,ETH_1972,Ethiopia,ETH,0,0,2,2
331,ETH_1980,Ethiopia,ETH,2,0,2,4
332,ETH_1992,Ethiopia,ETH,1,0,2,3
333,ETH_1996,Ethiopia,ETH,2,0,1,3
334,ETH_2000,Ethiopia,ETH,4,1,3,8
335,ETH_2004,Ethiopia,ETH,2,3,2,7
336,ETH_2008,Ethiopia,ETH,4,1,2,7
337,FIN_1906,Finland,FIN,2,1,1,4
338,FIN_1908,Finland,FIN,1,1,3,5
339,FIN_1912,Finland,FIN,9,8,9,26
340,FIN_1920,Finland,FIN,15,10,9,34
341,FIN_1924,Finland,FIN,14,13,10,37
342,FIN_1928,Finland,FIN,8,8,9,25
343,FIN_1932,Finland,FIN,5,8,12,25
344,FIN_1936,Finland,FIN,8,6,6,20
345,FIN_1948,Finland,FIN,10,8,6,24
346,FIN_1952,Finland,FIN,6,3,13,22
347,FIN_1956,Finland,FIN,3,1,11,15
348,FIN_1960,Finland,FIN,1,1,3,5
349,FIN_1964,Finland,FIN,3,0,2,5
350,FIN_1968,Finland,FIN,1,2,1,4
351,FIN_1972,Finland,FIN,3,1,4,8
352,FIN_1976,Finland,FIN,4,2,0,6
353,FIN_1980,Finland,FIN,3,1,4,8
354,FIN_1984,Finland,FIN,4,2,6,12
355,FIN_1988,Finland,FIN,1,1,2,4
356,FIN_1992,Finland,FIN,1,2,2,5
357,FIN_1996,Finland,FIN,1,2,1,4
358,FIN_2000,Finland,FIN,2,1,1,4
359,FIN_2004,Finland,FIN,0,2,0,2
360,FIN_2008,Finland,FIN,1,1,2,4
361,FRA_1896,France,FRA,5,4,2,11
362,FRA_1900,France,FRA,28,44,36,108
363,FRA_1906,France,FRA,15,9,16,40
364,FRA_1908,France,FRA,5,5,9,19
365,FRA_1912,France,FRA,8,5,3,16
366,FRA_1920,France,FRA,9,20,13,42
367,FRA_1924,France,FRA,14,15,12,41
368,FRA_1928,France,FRA,7,12,6,25
369,FRA_1932,France,FRA,11,5,4,20
370,FRA_1936,France,FRA,7,6,6,19
371,FRA_1948,France,FRA,11,6,15,32
372,FRA_1952,France,FRA,6,6,6,18
373,FRA_1956,France,FRA,4,4,6,14
374,FRA_1960,France,FRA,0,2,3,5
375,FRA_1964,France,FRA,1,8,6,15
376,FRA_1968,France,FRA,7,3,5,15
377,FRA_1972,France,FRA,2,4,7,13
378,FRA_1976,France,FRA,2,3,4,9
379,FRA_1980,France,FRA,6,5,3,14
380,FRA_1984,France,FRA,5,7,16,28
381,FRA_1988,France,FRA,6,4,6,16
382,FRA_1992,France,FRA,8,5,16,29
383,FRA_1996,France,FRA,15,7,15,37
384,FRA_2000,France,FRA,13,14,11,38
385,FRA_2004,France,FRA,11,9,13,33
386,FRA_2008,France,FRA,7,16,17,40
387,FRG_1968,West Germany,FRG,5,11,10,26
388,FRG_1972,West Germany,FRG,13,11,16,40
389,FRG_1976,West Germany,FRG,10,12,17,39
390,FRG_1984,West Germany,FRG,17,19,23,59
391,FRG_1988,West Germany,FRG,11,14,15,40
392,GBR_1896,United Kingdom,GBR,2,3,2,7
393,GBR_1900,United Kingdom,GBR,16,6,9,31
394,GBR_1904,United Kingdom,GBR,1,1,0,2
395,GBR_1906,United Kingdom,GBR,8,11,5,24
396,GBR_1908,United Kingdom,GBR,56,51,38,145
397,GBR_1912,United Kingdom,GBR,10,15,16,41
398,GBR_1920,United Kingdom,GBR,15,16,13,44
399,GBR_1924,United Kingdom,GBR,10,14,12,36
400,GBR_1928,United Kingdom,GBR,4,11,7,22
401,GBR_1932,United Kingdom,GBR,5,7,5,17
402,GBR_1936,United Kingdom,GBR,4,7,3,14
403,GBR_1948,United Kingdom,GBR,4,15,7,26
404,GBR_1952,United Kingdom,GBR,1,2,8,11
405,GBR_1956,United Kingdom,GBR,6,7,11,24
406,GBR_1960,United Kingdom,GBR,2,6,12,20
407,GBR_1964,United Kingdom,GBR,4,12,2,18
408,GBR_1968,United Kingdom,GBR,5,5,3,13
409,GBR_1972,United Kingdom,GBR,4,5,9,18
410,GBR_1976,United Kingdom,GBR,3,5,5,13
411,GBR_1980,United Kingdom,GBR,5,7,9,21
412,GBR_1984,United Kingdom,GBR,5,11,21,37
413,GBR_1988,United Kingdom,GBR,5,10,9,24
414,GBR_1992,United Kingdom,GBR,5,3,12,20
415,GBR_1996,United Kingdom,GBR,1,8,6,15
416,GBR_2000,United Kingdom,GBR,11,10,7,28
417,GBR_2004,United Kingdom,GBR,9,9,12,30
418,GBR_2008,United Kingdom,GBR,19,13,15,47
419,GDR_1968,East Germany,GDR,9,9,7,25
420,GDR_1972,East Germany,GDR,20,23,23,66
421,GDR_1976,East Germany,GDR,40,25,25,90
422,GDR_1980,East Germany,GDR,47,37,42,126
423,GDR_1988,East Germany,GDR,37,35,30,102
424,GEO_1996,Georgia,GEO,0,0,2,2
425,GEO_2000,Georgia,GEO,0,0,6,6
426,GEO_2004,Georgia,GEO,2,2,0,4
427,GEO_2008,Georgia,GEO,3,0,3,6
428,GER_1928,Germany,GER,11,9,19,39
429,GER_1932,Germany,GER,5,12,7,24
430,GER_1936,Germany,GER,38,31,32,101
431,GER_1952,Germany,GER,0,7,17,24
432,GER_1956,Germany,GER,6,13,7,26
433,GER_1960,Germany,GER,12,19,11,42
434,GER_1964,Germany,GER,10,22,18,50
435,GER_1992,Germany,GER,33,21,28,82
436,GER_1996,Germany,GER,20,18,27,65
437,GER_2000,Germany,GER,13,17,26,56
438,GER_2004,Germany,GER,13,16,20,49
439,GER_2008,Germany,GER,16,10,15,41
440,GHA_1960,Ghana,GHA,0,1,0,1
441,GHA_1964,Ghana,GHA,0,0,1,1
442,GHA_1972,Ghana,GHA,0,0,1,1
443,GHA_1992,Ghana,GHA,0,0,1,1
444,GRE_1896,Greece,GRE,10,17,19,46
445,GRE_1904,Greece,GRE,1,0,1,2
446,GRE_1906,Greece,GRE,8,13,13,34
447,GRE_1908,Greece,GRE,0,3,0,3
448,GRE_1912,Greece,GRE,1,0,1,2
449,GRE_1920,Greece,GRE,0,1,0,1
450,GRE_1924,Greece,GRE,1,0,0,1
451,GRE_1956,Greece,GRE,0,0,1,1
452,GRE_1960,Greece,GRE,1,0,0,1
453,GRE_1968,Greece,GRE,0,0,1,1
454,GRE_1972,Greece,GRE,0,2,0,2
455,GRE_1980,Greece,GRE,1,0,2,3
456,GRE_1984,Greece,GRE,0,1,1,2
457,GRE_1988,Greece,GRE,0,0,1,1
458,GRE_1992,Greece,GRE,2,0,0,2
459,GRE_1996,Greece,GRE,4,4,0,8
460,GRE_2000,Greece,GRE,5,5,3,13
461,GRE_2004,Greece,GRE,6,6,4,16
462,GRE_2008,Greece,GRE,0,2,2,4
463,GUY_1980,Guyana,GUY,0,0,1,1
464,HAI_1924,Haiti,HAI,0,0,1,1
465,HAI_1928,Haiti,HAI,0,1,0,1
466,HKG_1996,Hong Kong,HKG,1,0,0,1
467,HKG_2004,Hong Kong,HKG,0,1,0,1
468,HUN_1896,Hungary,HUN,2,1,3,6
469,HUN_1900,Hungary,HUN,1,2,2,5
470,HUN_1904,Hungary,HUN,2,1,1,4
471,HUN_1906,Hungary,HUN,2,5,3,10
472,HUN_1908,Hungary,HUN,3,4,2,9
473,HUN_1912,Hungary,HUN,3,2,3,8
474,HUN_1924,Hungary,HUN,2,4,4,10
475,HUN_1928,Hungary,HUN,5,5,0,10
476,HUN_1932,Hungary,HUN,6,5,5,16
477,HUN_1936,Hungary,HUN,10,1,5,16
478,HUN_1948,Hungary,HUN,10,5,12,27
479,HUN_1952,Hungary,HUN,16,10,16,42
480,HUN_1956,Hungary,HUN,9,10,7,26
481,HUN_1960,Hungary,HUN,6,8,7,21
482,HUN_1964,Hungary,HUN,10,7,5,22
483,HUN_1968,Hungary,HUN,10,10,12,32
484,HUN_1972,Hungary,HUN,6,13,16,35
485,HUN_1976,Hungary,HUN,4,5,13,22
486,HUN_1980,Hungary,HUN,7,10,15,32
487,HUN_1988,Hungary,HUN,11,6,6,23
488,HUN_1992,Hungary,HUN,11,12,7,30
489,HUN_1996,Hungary,HUN,7,4,10,21
490,HUN_2000,Hungary,HUN,8,6,3,17
491,HUN_2004,Hungary,HUN,8,6,3,17
492,HUN_2008,Hungary,HUN,3,5,2,10
493,INA_1988,Indonesia,INA,0,1,0,1
494,INA_1992,Indonesia,INA,2,2,1,5
495,INA_1996,Indonesia,INA,1,1,2,4
496,INA_2000,Indonesia,INA,1,3,2,6
497,INA_2004,Indonesia,INA,1,1,2,4
498,INA_2008,Indonesia,INA,1,1,3,5
499,IND_1948,India,IND,1,1,0,2
500,IND_1952,India,IND,1,0,1,2
501,IND_1956,India,IND,1,0,0,1
502,IND_1960,India,IND,0,1,0,1
503,IND_1964,India,IND,1,0,0,1
504,IND_1968,India,IND,0,0,1,1
505,IND_1972,India,IND,0,0,1,1
506,IND_1980,India,IND,1,0,0,1
507,IND_1996,India,IND,0,0,1,1
508,IND_2000,India,IND,0,0,1,1
509,IND_2004,India,IND,0,1,0,1
510,IND_2008,India,IND,1,0,2,3
511,INT_1896,International Team,INT,1,1,1,3
512,INT_1900,International Team,INT,6,3,3,12
513,INT_1904,International Team,INT,1,1,0,2
514,INT_1906,International Team,INT,0,2,0,2
515,IRI_1948,Iran,IRI,0,0,1,1
516,IRI_1952,Iran,IRI,0,3,4,7
517,IRI_1956,Iran,IRI,2,2,1,5
518,IRI_1960,Iran,IRI,0,1,3,4
519,IRI_1964,Iran,IRI,0,0,2,2
520,IRI_1968,Iran,IRI,2,1,2,5
521,IRI_1972,Iran,IRI,0,2,1,3
522,IRI_1976,Iran,IRI,0,1,1,2
523,IRI_1988,Iran,IRI,0,1,0,1
524,IRI_1992,Iran,IRI,0,1,2,3
525,IRI_1996,Iran,IRI,1,1,1,3
526,IRI_2000,Iran,IRI,3,0,1,4
527,IRI_2004,Iran,IRI,2,2,2,6
528,IRL_1924,Ireland,IRL,0,1,1,2
529,IRL_1928,Ireland,IRL,1,0,0,1
530,IRL_1932,Ireland,IRL,2,0,0,2
531,IRL_1948,Ireland,IRL,0,0,1,1
532,IRL_1952,Ireland,IRL,0,1,0,1
533,IRL_1956,Ireland,IRL,1,1,3,5
534,IRL_1964,Ireland,IRL,0,0,1,1
535,IRL_1980,Ireland,IRL,0,1,1,2
536,IRL_1984,Ireland,IRL,0,1,0,1
537,IRL_1992,Ireland,IRL,1,1,0,2
538,IRL_1996,Ireland,IRL,3,0,1,4
539,IRL_2000,Ireland,IRL,0,1,0,1
540,IRL_2008,Ireland,IRL,0,1,2,3
541,IRQ_1960,Iraq,IRQ,0,0,1,1
542,ISL_1956,Iceland,ISL,0,1,0,1
543,ISL_1984,Iceland,ISL,0,0,1,1
544,ISL_2000,Iceland,ISL,0,0,1,1
545,ISR_1992,Israel,ISR,0,1,1,2
546,ISR_1996,Israel,ISR,0,0,1,1
547,ISR_2000,Israel,ISR,0,0,1,1
548,ISR_2004,Israel,ISR,1,0,1,2
549,ISR_2008,Israel,ISR,0,0,1,1
550,ISV_1988,Virgin Islands US,ISV,0,1,0,1
551,ITA_1948,Italy,ITA,9,12,10,31
552,ITA_1952,Italy,ITA,8,9,4,21
553,ITA_1956,Italy,ITA,8,8,9,25
554,ITA_1960,Italy,ITA,13,10,13,36
555,ITA_1964,Italy,ITA,10,10,7,27
556,ITA_1968,Italy,ITA,3,4,9,16
557,ITA_1972,Italy,ITA,5,3,10,18
558,ITA_1976,Italy,ITA,2,7,4,13
559,ITA_1980,Italy,ITA,8,3,4,15
560,ITA_1984,Italy,ITA,14,6,12,32
561,ITA_1988,Italy,ITA,6,4,4,14
562,ITA_1992,Italy,ITA,6,5,8,19
563,ITA_1996,Italy,ITA,13,10,12,35
564,ITA_2000,Italy,ITA,13,8,13,34
565,ITA_2004,Italy,ITA,10,11,11,32
566,ITA_2008,Italy,ITA,8,10,10,28
567,JAM_1948,Jamaica,JAM,1,2,0,3
568,JAM_1952,Jamaica,JAM,2,3,0,5
569,JAM_1968,Jamaica,JAM,0,1,0,1
570,JAM_1972,Jamaica,JAM,0,0,1,1
571,JAM_1976,Jamaica,JAM,1,1,0,2
572,JAM_1980,Jamaica,JAM,0,0,3,3
573,JAM_1984,Jamaica,JAM,0,1,2,3
574,JAM_1988,Jamaica,JAM,0,2,0,2
575,JAM_1992,Jamaica,JAM,0,3,1,4
576,JAM_1996,Jamaica,JAM,1,3,2,6
577,JAM_2000,Jamaica,JAM,0,5,4,9
578,JAM_2004,Jamaica,JAM,2,1,2,5
579,JAM_2008,Jamaica,JAM,6,2,2,10
580,JPN_1920,Japan,JPN,0,2,0,2
581,JPN_1924,Japan,JPN,0,0,1,1
582,JPN_1928,Japan,JPN,2,2,1,5
583,JPN_1932,Japan,JPN,7,7,4,18
584,JPN_1936,Japan,JPN,6,4,10,20
585,JPN_1952,Japan,JPN,1,6,2,9
586,JPN_1956,Japan,JPN,4,10,5,19
587,JPN_1960,Japan,JPN,4,7,7,18
588,JPN_1964,Japan,JPN,16,5,8,29
589,JPN_1968,Japan,JPN,11,7,7,25
590,JPN_1972,Japan,JPN,13,8,8,29
591,JPN_1976,Japan,JPN,9,6,10,25
592,JPN_1984,Japan,JPN,10,8,14,32
593,JPN_1988,Japan,JPN,4,3,7,14
594,JPN_1992,Japan,JPN,3,8,11,22
595,JPN_1996,Japan,JPN,3,6,5,14
596,JPN_2000,Japan,JPN,5,8,5,18
597,JPN_2004,Japan,JPN,16,9,12,37
598,JPN_2008,Japan,JPN,9,5,9,23
599,KAZ_1996,Kazakhstan,KAZ,3,4,4,11
600,KAZ_2000,Kazakhstan,KAZ,3,4,0,7
601,KAZ_2004,Kazakhstan,KAZ,1,4,3,8
602,KAZ_2008,Kazakhstan,KAZ,2,4,6,12
603,KEN_1964,Kenya,KEN,0,0,1,1
604,KEN_1968,Kenya,KEN,3,4,2,9
605,KEN_1972,Kenya,KEN,2,3,4,9
606,KEN_1984,Kenya,KEN,1,0,2,3
607,KEN_1988,Kenya,KEN,5,2,2,9
608,KEN_1992,Kenya,KEN,2,4,2,8
609,KEN_1996,Kenya,KEN,1,4,3,8
610,KEN_2000,Kenya,KEN,2,3,2,7
611,KEN_2004,Kenya,KEN,1,4,2,7
612,KEN_2008,Kenya,KEN,5,5,4,14
613,KGZ_2000,Kyrgyzstan,KGZ,0,0,1,1
614,KGZ_2008,Kyrgyzstan,KGZ,0,1,1,2
615,KIT_1900,Italy (until 1946),KIT,2,2,0,4
616,KIT_1906,Italy (until 1946),KIT,7,6,3,16
617,KIT_1908,Italy (until 1946),KIT,2,2,0,4
618,KIT_1912,Italy (until 1946),KIT,5,1,2,8
619,KIT_1920,Italy (until 1946),KIT,14,6,5,25
620,KIT_1924,Italy (until 1946),KIT,8,3,5,16
621,KIT_1928,Italy (until 1946),KIT,7,6,7,20
622,KIT_1932,Italy (until 1946),KIT,12,12,12,36
623,KIT_1936,Italy (until 1946),KIT,9,13,5,27
624,KOR_1948,South Korea,KOR,0,0,2,2
625,KOR_1952,South Korea,KOR,0,0,2,2
626,KOR_1956,South Korea,KOR,0,1,1,2
627,KOR_1964,South Korea,KOR,0,2,1,3
628,KOR_1968,South Korea,KOR,0,1,1,2
629,KOR_1972,South Korea,KOR,0,1,0,1
630,KOR_1976,South Korea,KOR,1,1,4,6
631,KOR_1984,South Korea,KOR,6,6,7,19
632,KOR_1988,South Korea,KOR,12,10,11,33
633,KOR_1992,South Korea,KOR,12,5,12,29
634,KOR_1996,South Korea,KOR,7,15,5,27
635,KOR_2000,South Korea,KOR,8,10,10,28
636,KOR_2004,South Korea,KOR,9,12,9,30
637,KOR_2008,South Korea,KOR,13,10,8,31
638,KSA_2000,Saudi Arabia,KSA,0,1,1,2
639,KUW_2000,Kuwait,KUW,0,0,1,1
640,LAT_1932,Latvia,LAT,0,1,0,1
641,LAT_1936,Latvia,LAT,0,1,1,2
642,LAT_1992,Latvia,LAT,0,2,1,3
643,LAT_1996,Latvia,LAT,0,1,0,1
644,LAT_2000,Latvia,LAT,1,1,1,3
645,LAT_2004,Latvia,LAT,0,4,0,4
646,LAT_2008,Latvia,LAT,1,1,1,3
647,LIB_1952,Lebanon,LIB,0,1,1,2
648,LIB_1972,Lebanon,LIB,0,1,0,1
649,LIB_1980,Lebanon,LIB,0,0,1,1
650,LTU_1992,Lithuania,LTU,1,0,1,2
651,LTU_1996,Lithuania,LTU,0,0,1,1
652,LTU_2000,Lithuania,LTU,2,0,3,5
653,LTU_2004,Lithuania,LTU,1,2,0,3
654,LTU_2008,Lithuania,LTU,0,2,3,5
655,LUX_1920,Luxembourg,LUX,0,1,0,1
656,LUX_1924,Luxembourg,LUX,1,1,0,2
657,LUX_1928,Luxembourg,LUX,1,0,0,1
658,LUX_1952,Luxembourg,LUX,1,0,0,1
659,MAR_1960,Morocco,MAR,0,1,0,1
660,MAR_1984,Morocco,MAR,2,0,0,2
661,MAR_1988,Morocco,MAR,1,0,2,3
662,MAR_1992,Morocco,MAR,1,1,1,3
663,MAR_1996,Morocco,MAR,0,0,2,2
664,MAR_2000,Morocco,MAR,0,1,4,5
665,MAR_2004,Morocco,MAR,2,1,0,3
666,MAR_2008,Morocco,MAR,0,1,1,2
667,MAS_1992,Malaysia,MAS,0,0,1,1
668,MAS_1996,Malaysia,MAS,0,1,1,2
669,MAS_2008,Malaysia,MAS,0,1,0,1
670,MDA_1996,Moldova,MDA,0,1,1,2
671,MDA_2000,Moldova,MDA,0,1,1,2
672,MDA_2008,Moldova,MDA,0,0,1,1
673,MEX_1900,Mexico,MEX,0,0,1,1
674,MEX_1932,Mexico,MEX,0,2,0,2
675,MEX_1936,Mexico,MEX,0,0,3,3
676,MEX_1948,Mexico,MEX,2,1,2,5
677,MEX_1952,Mexico,MEX,0,1,0,1
678,MEX_1956,Mexico,MEX,1,0,1,2
679,MEX_1960,Mexico,MEX,0,0,1,1
680,MEX_1964,Mexico,MEX,0,0,1,1
681,MEX_1968,Mexico,MEX,3,3,3,9
682,MEX_1972,Mexico,MEX,0,1,0,1
683,MEX_1976,Mexico,MEX,1,0,1,2
684,MEX_1980,Mexico,MEX,0,1,3,4
685,MEX_1984,Mexico,MEX,2,3,1,6
686,MEX_1988,Mexico,MEX,0,0,2,2
687,MEX_1992,Mexico,MEX,0,1,0,1
688,MEX_1996,Mexico,MEX,0,0,1,1
689,MEX_2000,Mexico,MEX,1,2,3,6
690,MEX_2004,Mexico,MEX,0,3,1,4
691,MEX_2008,Mexico,MEX,2,0,1,3
692,MGL_1968,Mongolia,MGL,0,1,3,4
693,MGL_1972,Mongolia,MGL,0,1,0,1
694,MGL_1976,Mongolia,MGL,0,1,0,1
695,MGL_1980,Mongolia,MGL,0,2,2,4
696,MGL_1988,Mongolia,MGL,0,0,1,1
697,MGL_1992,Mongolia,MGL,0,0,2,2
698,MGL_1996,Mongolia,MGL,0,0,1,1
699,MGL_2004,Mongolia,MGL,0,0,1,1
700,MGL_2008,Mongolia,MGL,2,2,0,4
701,MKD_2000,Macedonia,MKD,0,0,1,1
702,MON_1924,Monaco,MON,0,0,1,1
703,MOZ_1996,Mozambique,MOZ,0,0,1,1
704,MOZ_2000,Mozambique,MOZ,1,0,0,1
705,MRI_2008,Mauritius,MRI,0,0,1,1
706,NAM_1992,Namibia,NAM,0,2,0,2
707,NAM_1996,Namibia,NAM,0,2,0,2
708,NED_1900,Netherlands,NED,0,1,3,4
709,NED_1906,Netherlands,NED,0,1,2,3
710,NED_1908,Netherlands,NED,0,0,2,2
711,NED_1912,Netherlands,NED,0,0,3,3
712,NED_1920,Netherlands,NED,4,2,5,11
713,NED_1924,Netherlands,NED,4,1,6,11
714,NED_1928,Netherlands,NED,8,10,5,23
715,NED_1932,Netherlands,NED,2,5,1,8
716,NED_1936,Netherlands,NED,6,4,7,17
717,NED_1948,Netherlands,NED,5,2,9,16
718,NED_1952,Netherlands,NED,0,5,0,5
719,NED_1960,Netherlands,NED,0,1,2,3
720,NED_1964,Netherlands,NED,2,4,4,10
721,NED_1968,Netherlands,NED,3,3,1,7
722,NED_1972,Netherlands,NED,3,1,1,5
723,NED_1976,Netherlands,NED,0,2,3,5
724,NED_1980,Netherlands,NED,0,1,2,3
725,NED_1984,Netherlands,NED,5,2,6,13
726,NED_1988,Netherlands,NED,2,2,5,9
727,NED_1992,Netherlands,NED,2,6,7,15
728,NED_1996,Netherlands,NED,4,5,10,19
729,NED_2000,Netherlands,NED,12,9,4,25
730,NED_2004,Netherlands,NED,4,9,9,22
731,NED_2008,Netherlands,NED,7,5,3,15
732,NGR_1964,Nigeria,NGR,0,0,1,1
733,NGR_1972,Nigeria,NGR,0,0,1,1
734,NGR_1984,Nigeria,NGR,0,1,1,2
735,NGR_1992,Nigeria,NGR,0,3,1,4
736,NGR_1996,Nigeria,NGR,2,1,3,6
737,NGR_2000,Nigeria,NGR,0,3,0,3
738,NGR_2004,Nigeria,NGR,0,0,2,2
739,NGR_2008,Nigeria,NGR,0,1,3,4
740,NIG_1972,Niger,NIG,0,0,1,1
741,NOR_1900,Norway,NOR,0,2,3,5
742,NOR_1906,Norway,NOR,4,2,1,7
743,NOR_1908,Norway,NOR,2,3,3,8
744,NOR_1912,Norway,NOR,4,1,4,9
745,NOR_1920,Norway,NOR,13,10,9,32
746,NOR_1924,Norway,NOR,5,2,3,10
747,NOR_1928,Norway,NOR,1,2,1,4
748,NOR_1936,Norway,NOR,1,3,2,6
749,NOR_1948,Norway,NOR,1,3,3,7
750,NOR_1952,Norway,NOR,3,2,0,5
751,NOR_1956,Norway,NOR,1,0,2,3
752,NOR_1960,Norway,NOR,1,0,0,1
753,NOR_1968,Norway,NOR,1,1,0,2
754,NOR_1972,Norway,NOR,2,1,1,4
755,NOR_1976,Norway,NOR,1,1,0,2
756,NOR_1984,Norway,NOR,0,1,2,3
757,NOR_1988,Norway,NOR,2,3,0,5
758,NOR_1992,Norway,NOR,2,4,1,7
759,NOR_1996,Norway,NOR,2,2,3,7
760,NOR_2000,Norway,NOR,4,3,3,10
761,NOR_2004,Norway,NOR,5,0,1,6
762,NOR_2008,Norway,NOR,3,5,2,10
763,NZL_1920,New Zealand,NZL,0,0,1,1
764,NZL_1924,New Zealand,NZL,0,0,1,1
765,NZL_1928,New Zealand,NZL,1,0,0,1
766,NZL_1932,New Zealand,NZL,0,1,0,1
767,NZL_1936,New Zealand,NZL,1,0,0,1
768,NZL_1952,New Zealand,NZL,1,0,2,3
769,NZL_1956,New Zealand,NZL,2,0,0,2
770,NZL_1960,New Zealand,NZL,2,0,1,3
771,NZL_1964,New Zealand,NZL,3,0,2,5
772,NZL_1968,New Zealand,NZL,1,0,2,3
773,NZL_1972,New Zealand,NZL,1,1,1,3
774,NZL_1976,New Zealand,NZL,2,1,1,4
775,NZL_1984,New Zealand,NZL,8,1,2,11
776,NZL_1988,New Zealand,NZL,3,2,8,13
777,NZL_1992,New Zealand,NZL,1,4,5,10
778,NZL_1996,New Zealand,NZL,3,2,1,6
779,NZL_2000,New Zealand,NZL,1,0,3,4
780,NZL_2004,New Zealand,NZL,3,2,0,5
781,NZL_2008,New Zealand,NZL,3,1,5,9
782,PAK_1956,Pakistan,PAK,0,1,0,1
783,PAK_1960,Pakistan,PAK,1,0,1,2
784,PAK_1964,Pakistan,PAK,0,1,0,1
785,PAK_1968,Pakistan,PAK,1,0,0,1
786,PAK_1972,Pakistan,PAK,0,1,0,1
787,PAK_1976,Pakistan,PAK,0,0,1,1
788,PAK_1984,Pakistan,PAK,1,0,0,1
789,PAK_1988,Pakistan,PAK,0,0,1,1
790,PAK_1992,Pakistan,PAK,0,0,1,1
791,PAN_1948,Panama,PAN,0,0,2,2
792,PAN_2008,Panama,PAN,1,0,0,1
793,PAR_2004,Paraguay,PAR,0,1,0,1
794,PER_1948,Peru,PER,1,0,0,1
795,PER_1984,Peru,PER,0,1,0,1
796,PER_1988,Peru,PER,0,1,0,1
797,PER_1992,Peru,PER,0,1,0,1
798,PHI_1928,Philippines,PHI,0,0,1,1
799,PHI_1932,Philippines,PHI,0,0,3,3
800,PHI_1936,Philippines,PHI,0,0,1,1
801,PHI_1964,Philippines,PHI,0,1,0,1
802,PHI_1988,Philippines,PHI,0,0,1,1
803,PHI_1992,Philippines,PHI,0,0,1,1
804,PHI_1996,Philippines,PHI,0,1,0,1
805,POL_1924,Poland,POL,0,1,1,2
806,POL_1928,Poland,POL,2,1,4,7
807,POL_1932,Poland,POL,3,2,4,9
808,POL_1936,Poland,POL,0,4,5,9
809,POL_1948,Poland,POL,1,0,1,2
810,POL_1952,Poland,POL,1,2,1,4
811,POL_1956,Poland,POL,1,4,4,9
812,POL_1960,Poland,POL,4,6,11,21
813,POL_1964,Poland,POL,7,6,10,23
814,POL_1968,Poland,POL,5,2,11,18
815,POL_1972,Poland,POL,7,5,9,21
816,POL_1976,Poland,POL,7,6,13,26
817,POL_1980,Poland,POL,3,14,15,32
818,POL_1988,Poland,POL,2,5,9,16
819,POL_1992,Poland,POL,3,6,10,19
820,POL_1996,Poland,POL,7,5,5,17
821,POL_2000,Poland,POL,6,5,3,14
822,POL_2004,Poland,POL,3,2,5,10
823,POL_2008,Poland,POL,3,6,1,10
824,POR_1924,Portugal,POR,0,0,1,1
825,POR_1928,Portugal,POR,0,0,1,1
826,POR_1936,Portugal,POR,0,0,1,1
827,POR_1948,Portugal,POR,0,1,1,2
828,POR_1952,Portugal,POR,0,0,1,1
829,POR_1960,Portugal,POR,0,1,0,1
830,POR_1976,Portugal,POR,0,2,0,2
831,POR_1984,Portugal,POR,1,0,2,3
832,POR_1988,Portugal,POR,1,0,0,1
833,POR_1996,Portugal,POR,1,0,1,2
834,POR_2000,Portugal,POR,0,0,2,2
835,POR_2004,Portugal,POR,0,2,1,3
836,POR_2008,Portugal,POR,1,1,0,2
837,PRK_1972,North Korea,PRK,1,1,3,5
838,PRK_1976,North Korea,PRK,1,1,0,2
839,PRK_1980,North Korea,PRK,0,3,2,5
840,PRK_1992,North Korea,PRK,4,0,5,9
841,PRK_1996,North Korea,PRK,2,1,2,5
842,PRK_2000,North Korea,PRK,0,1,3,4
843,PRK_2004,North Korea,PRK,0,4,1,5
844,PRK_2008,North Korea,PRK,2,1,3,6
845,PUR_1948,Puerto Rico,PUR,0,0,1,1
846,PUR_1976,Puerto Rico,PUR,0,0,1,1
847,PUR_1984,Puerto Rico,PUR,0,1,1,2
848,PUR_1992,Puerto Rico,PUR,0,0,1,1
849,PUR_1996,Puerto Rico,PUR,0,0,1,1
850,QAT_1992,Qatar,QAT,0,0,1,1
851,QAT_2000,Qatar,QAT,0,0,1,1
852,ROM_1924,Romania,ROM,0,0,1,1
853,ROM_1936,Romania,ROM,0,1,0,1
854,ROM_1952,Romania,ROM,1,1,2,4
855,ROM_1956,Romania,ROM,5,3,5,13
856,ROM_1960,Romania,ROM,3,1,6,10
857,ROM_1964,Romania,ROM,2,4,6,12
858,ROM_1968,Romania,ROM,4,6,5,15
859,ROM_1972,Romania,ROM,3,6,7,16
860,ROM_1976,Romania,ROM,4,9,14,27
861,ROM_1980,Romania,ROM,6,6,13,25
862,ROM_1984,Romania,ROM,20,16,17,53
863,ROM_1988,Romania,ROM,7,11,6,24
864,ROM_1992,Romania,ROM,4,6,8,18
865,ROM_1996,Romania,ROM,4,7,9,20
866,ROM_2000,Romania,ROM,11,6,8,25
867,ROM_2004,Romania,ROM,8,5,6,19
868,ROM_2008,Romania,ROM,4,1,3,8
869,RSA_1992,South Africa,RSA,0,2,0,2
870,RSA_1996,South Africa,RSA,3,1,1,5
871,RSA_2000,South Africa,RSA,0,2,3,5
872,RSA_2004,South Africa,RSA,1,3,2,6
873,RSA_2008,South Africa,RSA,0,1,0,1
874,RUS_1908,Russia,RUS,1,2,0,3
875,RUS_1912,Russia,RUS,0,2,3,5
876,RUS_1996,Russia,RUS,26,21,16,63
877,RUS_2000,Russia,RUS,32,28,28,88
878,RUS_2004,Russia,RUS,27,27,38,92
879,RUS_2008,Russia,RUS,23,21,28,72
880,SAF_1908,South Africa (until 1960),SAF,1,1,0,2
881,SAF_1912,South Africa (until 1960),SAF,4,2,0,6
882,SAF_1920,South Africa (until 1960),SAF,3,4,3,10
883,SAF_1924,South Africa (until 1960),SAF,1,1,1,3
884,SAF_1928,South Africa (until 1960),SAF,1,0,2,3
885,SAF_1932,South Africa (until 1960),SAF,2,0,3,5
886,SAF_1936,South Africa (until 1960),SAF,0,1,0,1
887,SAF_1948,South Africa (until 1960),SAF,2,2,2,6
888,SAF_1952,South Africa (until 1960),SAF,2,4,4,10
889,SAF_1956,South Africa (until 1960),SAF,0,0,4,4
890,SAF_1960,South Africa (until 1960),SAF,0,1,2,3
891,SEN_1988,Senegal,SEN,0,1,0,1
892,SIN_1960,Singapore,SIN,0,1,0,1
893,SIN_2008,Singapore,SIN,0,1,0,1
894,SLO_1992,Slovenia,SLO,0,0,2,2
895,SLO_1996,Slovenia,SLO,0,2,0,2
896,SLO_2000,Slovenia,SLO,2,0,0,2
897,SLO_2004,Slovenia,SLO,0,1,3,4
898,SLO_2008,Slovenia,SLO,1,2,2,5
899,SRB_2008,Serbia,SRB,0,1,2,3
900,SRI_1948,Sri Lanka,SRI,0,1,0,1
901,SRI_2000,Sri Lanka,SRI,0,1,0,1
902,SUD_2008,Sudan,SUD,0,1,0,1
903,SUI_1896,Switzerland,SUI,1,2,0,3
904,SUI_1900,Switzerland,SUI,6,2,1,9
905,SUI_1904,Switzerland,SUI,1,0,1,2
906,SUI_1906,Switzerland,SUI,5,6,4,15
907,SUI_1912,Switzerland,SUI,1,0,0,1
908,SUI_1920,Switzerland,SUI,2,2,7,11
909,SUI_1924,Switzerland,SUI,7,8,10,25
910,SUI_1928,Switzerland,SUI,7,6,4,17
911,SUI_1932,Switzerland,SUI,0,1,0,1
912,SUI_1936,Switzerland,SUI,4,9,5,18
913,SUI_1948,Switzerland,SUI,5,12,5,22
914,SUI_1952,Switzerland,SUI,2,6,6,14
915,SUI_1956,Switzerland,SUI,0,0,1,1
916,SUI_1960,Switzerland,SUI,0,3,3,6
917,SUI_1964,Switzerland,SUI,1,2,1,4
918,SUI_1968,Switzerland,SUI,0,1,4,5
919,SUI_1972,Switzerland,SUI,0,3,0,3
920,SUI_1976,Switzerland,SUI,1,1,2,4
921,SUI_1980,Switzerland,SUI,2,0,0,2
922,SUI_1984,Switzerland,SUI,0,4,4,8
923,SUI_1988,Switzerland,SUI,0,2,2,4
924,SUI_1992,Switzerland,SUI,1,0,0,1
925,SUI_1996,Switzerland,SUI,4,3,0,7
926,SUI_2000,Switzerland,SUI,1,6,2,9
927,SUI_2004,Switzerland,SUI,1,1,3,5
928,SUI_2008,Switzerland,SUI,1,0,4,5
929,SUR_1988,Suriname,SUR,1,0,0,1
930,SUR_1992,Suriname,SUR,0,0,1,1
931,SVK_1996,Slovak Rep.,SVK,1,1,1,3
932,SVK_2000,Slovak Rep.,SVK,1,3,1,5
933,SVK_2004,Slovak Rep.,SVK,2,2,2,6
934,SVK_2008,Slovak Rep.,SVK,3,2,1,6
935,SWE_1900,Sweden,SWE,0,0,1,1
936,SWE_1906,Sweden,SWE,2,5,7,14
937,SWE_1908,Sweden,SWE,8,6,11,25
938,SWE_1912,Sweden,SWE,24,24,17,65
939,SWE_1920,Sweden,SWE,19,20,24,63
940,SWE_1924,Sweden,SWE,4,13,12,29
941,SWE_1928,Sweden,SWE,7,6,12,25
942,SWE_1932,Sweden,SWE,10,5,9,24
943,SWE_1936,Sweden,SWE,6,5,10,21
944,SWE_1948,Sweden,SWE,17,11,18,46
945,SWE_1952,Sweden,SWE,12,13,10,35
946,SWE_1956,Sweden,SWE,8,5,6,19
947,SWE_1960,Sweden,SWE,1,2,3,6
948,SWE_1964,Sweden,SWE,2,2,4,8
949,SWE_1968,Sweden,SWE,2,1,1,4
950,SWE_1972,Sweden,SWE,4,6,6,16
951,SWE_1976,Sweden,SWE,4,1,0,5
952,SWE_1980,Sweden,SWE,3,3,6,12
953,SWE_1984,Sweden,SWE,2,11,6,19
954,SWE_1988,Sweden,SWE,0,4,7,11
955,SWE_1992,Sweden,SWE,1,7,4,12
956,SWE_1996,Sweden,SWE,2,4,2,8
957,SWE_2000,Sweden,SWE,4,5,3,12
958,SWE_2004,Sweden,SWE,4,2,1,7
959,SWE_2008,Sweden,SWE,0,4,1,5
960,SYR_1984,Syria,SYR,0,1,0,1
961,SYR_1996,Syria,SYR,1,0,0,1
962,SYR_2004,Syria,SYR,0,0,1,1
963,TAN_1980,Tanzania,TAN,0,2,0,2
964,TGA_1996,Tonga,TGA,0,1,0,1
965,THA_1976,Thailand,THA,0,0,1,1
966,THA_1984,Thailand,THA,0,1,0,1
967,THA_1988,Thailand,THA,0,0,1,1
968,THA_1992,Thailand,THA,0,0,1,1
969,THA_1996,Thailand,THA,1,0,1,2
970,THA_2000,Thailand,THA,1,0,2,3
971,THA_2004,Thailand,THA,3,1,4,8
972,THA_2008,Thailand,THA,2,2,0,4
973,TJK_2008,Tajikistan,TJK,0,1,1,2
974,TOG_2008,Togo,TOG,0,0,1,1
975,TPE_1960,Taiwan,TPE,0,1,0,1
976,TPE_1968,Taiwan,TPE,0,0,1,1
977,TPE_1984,Taiwan,TPE,0,0,1,1
978,TPE_1992,Taiwan,TPE,0,1,0,1
979,TPE_1996,Taiwan,TPE,0,1,0,1
980,TPE_2000,Taiwan,TPE,0,1,4,5
981,TPE_2004,Taiwan,TPE,2,2,1,5
982,TPE_2008,Taiwan,TPE,0,0,4,4
983,TRI_1948,Trinidad & Tobago,TRI,0,1,0,1
984,TRI_1952,Trinidad & Tobago,TRI,0,0,2,2
985,TRI_1964,Trinidad & Tobago,TRI,0,1,2,3
986,TRI_1976,Trinidad & Tobago,TRI,1,0,0,1
987,TRI_1996,Trinidad & Tobago,TRI,0,0,2,2
988,TRI_2000,Trinidad & Tobago,TRI,0,1,1,2
989,TRI_2004,Trinidad & Tobago,TRI,0,0,1,1
990,TRI_2008,Trinidad & Tobago,TRI,0,2,0,2
991,TUN_1964,Tunisia,TUN,0,1,1,2
992,TUN_1968,Tunisia,TUN,1,0,1,2
993,TUN_1972,Tunisia,TUN,0,1,0,1
994,TUN_1996,Tunisia,TUN,0,0,1,1
995,TUN_2008,Tunisia,TUN,1,0,0,1
996,TUR_1936,Turkey,TUR,1,0,1,2
997,TUR_1948,Turkey,TUR,6,4,2,12
998,TUR_1952,Turkey,TUR,2,0,1,3
999,TUR_1956,Turkey,TUR,3,2,2,7
1000,TUR_1960,Turkey,TUR,7,2,0,9
1001,TUR_1964,Turkey,TUR,2,3,1,6
1002,TUR_1968,Turkey,TUR,2,0,0,2
1003,TUR_1972,Turkey,TUR,0,1,0,1
1004,TUR_1984,Turkey,TUR,0,0,3,3
1005,TUR_1988,Turkey,TUR,1,1,0,2
1006,TUR_1992,Turkey,TUR,2,2,2,6
1007,TUR_1996,Turkey,TUR,4,1,1,6
1008,TUR_2000,Turkey,TUR,3,0,2,5
1009,TUR_2004,Turkey,TUR,3,3,4,10
1010,TUR_2008,Turkey,TUR,1,4,3,8
1011,UAE_2004,United Arab Emirates,UAE,1,0,0,1
1012,UGA_1968,Uganda,UGA,0,1,1,2
1013,UGA_1972,Uganda,UGA,1,1,0,2
1014,UGA_1980,Uganda,UGA,0,1,0,1
1015,UGA_1996,Uganda,UGA,0,0,1,1
1016,UKR_1996,Ukraine,UKR,9,2,12,23
1017,UKR_2000,Ukraine,UKR,3,10,10,23
1018,UKR_2004,Ukraine,UKR,9,5,9,23
1019,UKR_2008,Ukraine,UKR,7,5,15,27
1020,URS_1952,Soviet Union,URS,22,30,19,71
1021,URS_1956,Soviet Union,URS,37,29,32,98
1022,URS_1960,Soviet Union,URS,43,29,31,103
1023,URS_1964,Soviet Union,URS,30,31,35,96
1024,URS_1968,Soviet Union,URS,29,32,30,91
1025,URS_1972,Soviet Union,URS,50,27,22,99
1026,URS_1976,Soviet Union,URS,49,41,35,125
1027,URS_1980,Soviet Union,URS,80,69,46,195
1028,URS_1988,Soviet Union,URS,55,31,46,132
1029,URS_1992,Soviet Union,URS,45,38,29,112
1030,URU_1924,Uruguay,URU,1,0,0,1
1031,URU_1928,Uruguay,URU,1,0,0,1
1032,URU_1932,Uruguay,URU,0,0,1,1
1033,URU_1948,Uruguay,URU,0,1,1,2
1034,URU_1952,Uruguay,URU,0,0,2,2
1035,URU_1956,Uruguay,URU,0,0,1,1
1036,URU_1964,Uruguay,URU,0,0,1,1
1037,URU_2000,Uruguay,URU,0,1,0,1
1038,USA_1896,United States,USA,11,7,2,20
1039,USA_1900,United States,USA,19,14,15,48
1040,USA_1904,United States,USA,78,82,79,239
1041,USA_1906,United States,USA,12,6,6,24
1042,USA_1908,United States,USA,23,12,12,47
1043,USA_1912,United States,USA,26,19,19,64
1044,USA_1920,United States,USA,41,27,27,95
1045,USA_1924,United States,USA,45,27,27,99
1046,USA_1928,United States,USA,22,18,16,56
1047,USA_1932,United States,USA,44,36,30,110
1048,USA_1936,United States,USA,24,21,12,57
1049,USA_1948,United States,USA,38,27,19,84
1050,USA_1952,United States,USA,40,19,17,76
1051,USA_1956,United States,USA,32,25,17,74
1052,USA_1960,United States,USA,34,21,16,71
1053,USA_1964,United States,USA,36,26,28,90
1054,USA_1968,United States,USA,45,28,34,107
1055,USA_1972,United States,USA,33,31,30,94
1056,USA_1976,United States,USA,34,35,25,94
1057,USA_1984,United States,USA,83,61,30,174
1058,USA_1988,United States,USA,36,31,27,94
1059,USA_1992,United States,USA,37,34,37,108
1060,USA_1996,United States,USA,44,32,25,101
1061,USA_2000,United States,USA,37,24,31,92
1062,USA_2004,United States,USA,36,39,28,103
1063,USA_2008,United States,USA,36,38,36,110
1064,UZB_1996,Uzbekistan,UZB,0,1,1,2
1065,UZB_2000,Uzbekistan,UZB,1,1,2,4
1066,UZB_2004,Uzbekistan,UZB,2,1,2,5
1067,UZB_2008,Uzbekistan,UZB,1,2,3,6
1068,VEN_1952,Venezuela,VEN,0,0,1,1
1069,VEN_1960,Venezuela,VEN,0,0,1,1
1070,VEN_1968,Venezuela,VEN,1,0,0,1
1071,VEN_1976,Venezuela,VEN,0,1,0,1
1072,VEN_1980,Venezuela,VEN,0,1,0,1
1073,VEN_1984,Venezuela,VEN,0,0,3,3
1074,VEN_2004,Venezuela,VEN,0,0,2,2
1075,VEN_2008,Venezuela,VEN,0,0,1,1
1076,VIE_2000,Vietnam,VIE,0,1,0,1
1077,VIE_2008,Vietnam,VIE,0,1,0,1
1078,YUF_1992,Yugoslav Federation,YUF,0,1,2,3
1079,YUF_1996,Yugoslav Federation,YUF,1,1,2,4
1080,YUF_2000,Yugoslav Federation,YUF,1,1,1,3
1081,YUF_2004,Yugoslav Federation,YUF,0,2,0,2
1082,YUG_1924,Yugoslavia (until 1988),YUG,2,0,0,2
1083,YUG_1928,Yugoslavia (until 1988),YUG,1,1,3,5
1084,YUG_1936,Yugoslavia (until 1988),YUG,0,1,0,1
1085,YUG_1948,Yugoslavia (until 1988),YUG,0,2,0,2
1086,YUG_1952,Yugoslavia (until 1988),YUG,1,2,0,3
1087,YUG_1956,Yugoslavia (until 1988),YUG,0,3,0,3
1088,YUG_1960,Yugoslavia (until 1988),YUG,1,1,0,2
1089,YUG_1964,Yugoslavia (until 1988),YUG,2,1,2,5
1090,YUG_1968,Yugoslavia (until 1988),YUG,3,3,2,8
1091,YUG_1972,Yugoslavia (until 1988),YUG,2,1,2,5
1092,YUG_1976,Yugoslavia (until 1988),YUG,2,3,3,8
1093,YUG_1980,Yugoslavia (until 1988),YUG,2,3,4,9
1094,YUG_1984,Yugoslavia (until 1988),YUG,7,4,7,18
1095,YUG_1988,Yugoslavia (until 1988),YUG,3,4,5,12
1096,ZAM_1984,Zambia,ZAM,0,0,1,1
1097,ZAM_1996,Zambia,ZAM,0,1,0,1
1098,ZIM_1980,Zimbabwe,ZIM,1,0,0,1
1099,ZIM_2004,Zimbabwe,ZIM,1,1,1,3
1100,ZIM_2008,Zimbabwe,ZIM,1,3,0,4
